00000000000000000000000000000000000000000000000000
00000000000000000000000000000000000000000000000000
00002222200022222200000000000000000000000000000000
00002111222221111200000000000000000000000000000000
00002111111111111200000000000000000000000000000000
00002111222221111200000000000000000000000000000000
00002111200021111200000000000000000000000000000000
00002111222222122200000000000000000000000000000000
00002111111202120000000000000000000000000000000000
00002212211222122222222220000000000000000000000000
00000212111111111111111120000000000000000000000000
00000211111222122222222120000000000000000000000000
00000211111202122222202122222200000000000000000000
00000211111202111111202121111200000000000000000000
00000212111222111111222111111200000000000000000000
00000211111111111111111111111200000000000000000000
00000222122222111111222111111200000000000000000000
00000002120002111111202111111200000000000000000000
00000002120002111111202111111200000000000000000000
00000002120002122222202122122200000000000000000000
00000002120002120000002122120000000000000000000000
00000002120002120000002122120000000000000000000000
00000002120002120000002122120000000000000000000000
00000002120002120000002122120000000000000000000000
00000002120002120000002122120000000000000000000000
00000002120002120000002122120000000000000000000000
00000002120002120000222122120000000000000000000000
00000002120002120000211111120000000000000000000000
00000002120002120000211111120000000000000000000000
00000002120002120000211111120000000000000000000000
00000002120002120000211111120000000000000000000000
00000002120002120000211111120000000000000000000000
00000222122222111111222111111200000000000000000000
00000211111202120000000002120000000000000000000000
00000211111222120000000002120000000000000000000000
00000211111111122222222222120000000000000000000000
00000211111111111111111111120000000000000000000000
00000222211211122222222222220000000000000000000000
00000000211111120000000000000000000000000000000000
00000000222222220000000000000000000000000000000000
00000000000000000000000000000000000000000000000000
00000000000000000000000000000000000000000000000000
00000000000000000000000000000000000000000000000000
00000000000000000000000000000000000000000000000000
00000000000000000000000000000000000000000000000000
00000000000000000000000000000000000000000000000000
00000000000000000000000000000000000000000000000000
00000000000000000000000000000000000000000000000000
00000000000000000000000000000000000000000000000000
00000000000000000000000000000000000000000000000000
